"bm" = (/turf/simulated/floor/trim/carpet/purple,/area/space)
"bO" = (/turf/simulated/floor/grid,/area/space)
"cu" = (/turf/simulated/floor/trim/carpet/gpurple,/area/space)
"dP" = (/turf/simulated/floor/trim/wood/broken6,/area/space)
"dS" = (/turf/simulated/floor/sand_floor,/area/space)
"hj" = (/turf/simulated/floor/reinforced,/area/space)
"hp" = (/turf/simulated/floor/tiled/white/mono,/area/space)
"hN" = (/turf/simulated/floor/grid/greengrid,/area/space)
"hZ" = (/turf/simulated/floor/trim/carpet,/area/space)
"jk" = (/turf/simulated/floor/natural/sand/gray,/area/space)
"kO" = (/turf/simulated/floor/trim/carpet/orange,/area/space)
"lr" = (/turf/simulated/floor/plating,/area/space)
"lz" = (/turf/simulated/mineral/air,/area/space)
"lI" = (/turf/simulated/floor/trim/wood,/area/space)
"lZ" = (/turf/simulated/floor/natural/sand/cave,/area/space)
"my" = (/turf/simulated/floor/natural/sand/pure,/area/space)
"or" = (/turf/simulated/floor/trim/carpet/oldred,/area/space)
"ps" = (/turf/simulated/floor/tiled/dark/usedup,/area/space)
"qT" = (/turf/simulated/wall/r_wall,/area/space)
"sq" = (/turf/simulated/floor/grid/bluegrid,/area/space)
"sD" = (/turf/simulated/open,/area/space)
"uN" = (/turf/simulated/floor/trim/darkwood,/area/space)
"wF" = (/turf/simulated/floor/trim/carpet/red,/area/space)
"xk" = (/turf/simulated/floor,/area/space)
"xs" = (/turf/simulated/floor/trim/carpet/blue,/area/space)
"xX" = (/turf/unsimulated/mineral,/area/space)
"yn" = (/turf/simulated/floor/tiled/dark/rough,/area/space)
"AU" = (/turf/simulated/floor/trim/carpet/blue2,/area/space)
"BM" = (/turf/simulated/wall/wood,/area/space)
"BR" = (/turf/simulated/floor/tiled/freezer,/area/space)
"Cu" = (/turf/simulated/floor/natural/grass,/area/space)
"DS" = (/turf/simulated/floor/tiled/white/rough,/area/space)
"HE" = (/turf/simulated/floor/tiled/dark/mono,/area/space)
"Id" = (/turf/simulated/floor/trim/lino,/area/space)
"Kf" = (/turf/simulated/floor/tiled/dark,/area/space)
"KZ" = (/turf/simulated/floor/natural/jungle/dirt,/area/space)
"Lx" = (/turf/simulated/floor/trim/carpet/gblue,/area/space)
"Nq" = (/turf/simulated/mineral,/area/space)
"Oo" = (/turf/simulated/floor/tiled/techfloor,/area/space)
"Pg" = (/turf/simulated/floor/tiled/rough,/area/space)
"Qw" = (/turf/simulated/floor/tiled/white,/area/space)
"TS" = (/turf/simulated/wall,/area/space)
"Uo" = (/turf/simulated/floor/misc/concrete,/area/space)
"VC" = (/turf/simulated/floor/natural/sand/darksand,/area/space)

(1,1,1) = {"
xXxXxXxXxXxXxXxXxXxXxXxXxXxXxXxXxXxXxXxXxXxXxXxXxXxXxXxXxXxXxXxXxXxXxXxXxXxXxXxXxXxXxXxXxXxXxXxXxXxXxXxXxXxXxXxXxXxXxXxXxXxXxXxXxXxXxXxXxXxXxXxXxXxXxXxXxXxXxXxXxXxXxXxXxXxXxXxXxXxXxXxXxXxXxXxXxXxXxXxX
xXxXxXxXxXxXxXxXxXxXxXxXxXxXxXxXxXxXxXxXxXxXxXxXxXxXxXxXxXxXxXxXxXxXxXxXxXxXxXxXxXxXxXxXxXxXxXxXxXxXxXxXxXxXxXxXxXxXxXxXxXxXxXxXxXxXxXxXxXxXxXxXxXxXxXxXxXxXxXxXxXxXxXxXxXxXxXxXxXxXxXxXxXxXxXxXxXxXxXxX
xXxXxXxXxXxXxXxXxXxXxXxXxXxXxXxXxXxXxXxXxXxXxXxXxXxXxXxXxXxXxXxXxXxXxXxXxXxXxXxXxXxXxXxXxXxXxXxXxXxXxXxXxXxXxXxXxXxXxXxXxXxXxXxXxXxXxXxXxXxXxXxXxXxXxXxXxXxXxXxXxXxXxXxXxXxXxXxXxXxXxXxXxXxXxXxXxXxXxXxX
xXxXxXxXxXxXxXxXxXxXxXxXxXxXxXxXxXxXxXxXxXxXxXxXxXxXxXxXxXxXxXxXxXxXxXxXxXxXxXxXxXxXxXxXxXxXxXxXxXjkUoUoUojkxXxXxXxXxXxXxXxXxXxXxXxXxXxXxXxXxXxXxXxXxXxXxXxXxXxXxXxXxXxXxXxXxXxXxXxXxXxXxXxXxXxXxXxXxXxX
xXxXxXxXxXxXxXxXxXxXxXxXxXxXxXxXxXxXxXxXxXxXxXxXxXxXxXxXxXxXxXxXxXxXxXxXxXxXxXxXxXxXxXxXxXxXxXxXxXjkUoUoUojkxXxXxXxXxXxXxXxXxXxXxXxXxXxXxXxXxXxXxXxXxXxXxXxXxXxXxXxXxXxXxXxXxXxXxXxXxXxXxXxXxXxXxXxXxXxX
xXxXxXxXxXxXxXxXxXxXxXxXxXxXxXxXxXxXxXxXxXxXxXxXxXxXxXxXxXxXxXxXxXxXxXxXxXxXxXxXxXxXxXxXxXxXxXxXxXjkUoUoUojkxXxXxXxXxXxXxXxXxXxXxXxXxXxXxXxXxXxXxXxXxXxXxXxXxXxXxXxXxXxXxXxXxXxXxXxXxXxXxXxXxXxXxXxXxXxX
xXxXxXxXxXxXxXxXxXxXxXxXxXxXxXxXxXxXxXxXxXxXxXxXxXxXxXxXxXxXxXxXxXxXxXxXxXxXxXxXxXxXxXxXxXxXxXxXxXjkUoUoHEjkxXxXxXxXxXxXxXxXxXxXxXxXxXxXxXxXxXxXxXxXxXxXxXxXxXxXxXxXxXxXxXxXxXxXxXxXxXxXxXxXxXxXxXxXxXxX
xXxXxXxXxXxXNqNqNqNqNqNqNqNqNqNqNqNqNqNqNqNqNqNqNqNqNqNqNqNqNqNqNqNqNqNqNqNqNqNqNqNqNqNqNqNqNqNqNqjkUoHEHEjkNqNqNqNqNqNqNqNqNqNqNqNqNqNqNqNqNqNqNqNqNqNqNqjkNqNqxXxXxXxXxXNqNqNqNqNqNqNqNqNqxXxXxXxXxXxX
xXxXxXxXxXxXNqNqNqNqNqNqTSTSTSTSTSTSTSTSTSTSTSTSTSTSTSTSTSTSTSNqNqNqNqNqNqNqNqNqNqNqNqNqNqNqNqNqNqjkHEHEHEjkNqNqNqNqNqNqNqNqNqNqNqNqNqjkjkjkjkjkjkjkjkjkjkjkNqNqxXxXxXxXxXNqNqNqNqNqNqNqNqNqxXxXxXxXxXxX
xXxXxXxXxXxXNqNqNqNqNqNqTSlIlITSBRBRBRTSlIlITSBRBRBRTSorororTSNqjkjkjkjkjkjkjkjkNqNqNqNqjkjkjkjkjkHEHEHEHEHEjkjkjkjkjkjkjkNqNqNqNqjkjkjkjkjkjkjkjkjkjkjkjkjkNqNqxXxXxXxXxXxXNqNqNqNqNqNqNqNqxXxXxXxXxXxX
xXxXxXxXxXxXNqNqNqNqNqNqTSlIlIBRBRBRBRTSdPlIlIBRBRBRTSorororTSNqjkjkjkjkjkjkjkjkjkjkjkjkjkjkjkjkjkjkHEHEHEjkjkjkjkjkjkjkjkjkjkjkjkjkjkjkjkjkjkjkHEjkjkjkjkjkjkjkxXxXxXxXxXxXxXxXxXxXxXxXxXNqxXxXxXxXxXxX
xXxXxXxXxXxXNqNqNqNqNqNqTSlIlITSTSTSTSTSlIlITSTSTSTSTSorororTSjkjkjkjkjkjkjkjkjkjkjkjkjkjkjkjkjkjkjkHEHEHEjkBMBMBMBMBMjkBMBMBMBMBMjkjkjkjkjkjkjkHEjkjkjkjkjkjkjkxXxXxXxXxXxXxXxXxXxXxXxXxXNqxXxXxXxXxXxX
xXxXxXxXxXxXNqTSTSTSTSTSTSlIlIlIlIlIlITSlIlIlIlIdPlITSlIlIlITSTSTSTSxkxkTSxkxkTSTSTSTSTSTSlrlrTSjkjkHEHEHEjkBMIdIdIdBMjkBMIdIdIdBMjkjkjkjkjkjkjkHEjkjkjkjkjkjkjkxXxXxXxXxXxXxXxXxXxXxXxXxXNqxXxXxXxXxXxX
xXxXxXxXxXxXNqTSlIlIlIlITSlIlIlIlIlIlITSlIlIlIlIlIlITSlIlIlITShpDSDShphphphpDSDSDShpTSBRBRBRBRTSjkjkHEHEHEjkBMIdIdIdBMjkBMIdIdIdBMjkjkjkjkjkjkjkHEjkjkjkjkjkjkjkxXxXxXxXxXxXxXxXxXxXxXxXxXNqxXxXxXxXxXxX
xXxXxXxXxXxXNqTSlIlIlIlITSTSTSlITSTSTSTSTSTSlITSTSTSTSlIlIlIOohpDSDSDSDSDSDSDSDSDShpTSTSTSBRBRBRHEHEHEHEHEjkBMIdIdIdBMjkBMIdIdIdIdHEHEHEHEHEHEHEHEHEHEHEHEjkjkjkxXxXxXxXxXxXxXxXxXxXxXxXxXNqxXxXxXxXxXxX
xXxXxXxXxXxXNqTSuNlIlIlIlIlIlIlIlIlIlIlIlIlIlIlIlIlIlIlIlIlITShpDSDSDSDSDSDSDSDSDShpTSBRBRBRTSTSjkjkHEHEHEjkBMIdIdIdBMjkBMIdIdIdIdHEHEHEHEHEHEHEHEHEHEHEHEjkjkjkjkTSTSTSTSxXxXxXxXxXxXxXNqNqxXxXxXxXxXxX
xXxXxXxXxXxXNqTSuNlIlIlITSlIlIlIlIlIlIlIlIlIlIlIlIlIlIlIlIlITShphphphphphplIlIlIlITSTSTSTSTSTSjkjkjkHEHEHEjkBMlrIdlrBMynBMBMIdBMBMjkjkjkjkjkjkjkHEjkjkjkjkjkjkHEHElrlrlrTSxXxXxXxXxXxXxXNqNqxXxXxXxXxXxX
xXxXxXxXxXxXNqTSTSTSTSTSTSTSTSTSTSTSTSTSTSTSTSTSlIlITSxklIxkTSTSxkxkxkTSTSlIlIlIororTSlrlrlrTSjkjkjkHEHEHEjkBMlIlIcucucucuculIlIBMHEHEHEHEHEHEHEHEHEHEHEHEHEHEHEHETSlrlrTSxXxXxXxXxXxXxXNqNqxXxXxXxXxXxX
xXxXxXxXxXxXNqNqNqNqNqNqNqqTqTqTqTqTqTqTqTqTNqTSlIlITSOoOoOowFwFwFwFwFwFTSlIlIlIororTSynynynTSTSHEHEHEHEHEjkBMlIlIcucucucuculIlIBMHEHEHEHEHEHEHEHEHEHEHEHEHEHEHEHETSlrlrTSxXxXxXxXxXxXxXNqNqxXxXxXxXxXxX
xXxXxXxXxXxXNqNqqTqTqTqTqTqTHEHETSHEHEHEHEqTNqTSlIlITSOoOoOowFlIlIlIlIlIlIlIlIlIororTSDSDSDSHEHEHEHEHEHEHEjkBMlIlIcucucucuculIlIBMHEHEjkjkjkjkjkHEjkjkjkjkHETSTSTSTSTSTSTSTSTSxXxXxXjkjkjkxXxXxXxXxXxXxX
xXxXxXxXxXxXNqNqqTHEHEHEHEqTHEHETSynynynynqTNqTSlIlITSOoOoOowFlIlIlIlIlIlIlIlIlIororTSDSDSDSHEHEHEHEHEHEHEjkBMlIlIcucucucuculIlIBMHEHEjkjkjkjkjkHEjkjkjkjkHETSpspspspsTSpspsTSxXxXjkjkjkjkjkxXxXxXxXxXxX
xXxXxXxXxXxXNqNqqTHEHEHEHEqTHEHETSHEHEHEHEqTNqTSlIlIOoOoOoOowFlIlIwFwFwFTSlIlIlIororTSynynynTSTSHEHEHEHEHEjkynlIlIcucucucuculIlIynHEHEjkjkjkjkjkHEjkjkjkjkHETSpspspspsTSpspsTSTSTSjkjkjkjkjkxXxXxXxXxXxX
xXxXxXxXxXxXNqNqqTHEHEHEHEqTTSHETSTSPgPgPgTSTSTSlIlITSOoOoOowFlIlIwFwFwFxklIlIlIororTSlrlrlrTSjkjkjkHEHEHEjkynlIlIcucucucuculIlIynHEHEjkjkjkjkjkHEjkjkjkjkHETSpspspspsTSpspspspspsjkjkjkjkjkxXxXxXxXxXxX
xXxXxXxXxXxXNqNqqTHEHEHEHETSHEHEHEHEHEHEynynHETSlIlITSwFwFwFwFlIlIwFwFwFxklIlIlIororTSTSTSTSTSjkjkjkHEHEHEjkynlIlIcucucucuculIlIynHEHEjkjkjkjkjkHEjkjkjkjkHETSpspspspsTSpspspspspsjkjkjkjkjkxXxXxXxXxXxX
xXxXxXxXxXxXNqNqqTHEHEHEHEHEHEHEHEHEHEHEHEHEynTSlIlIxklIlIlIlIlIlIlIlIlITSTSlITSTSTSTSlrlrqTjkjkjkjkHEHEHEjkBMlIlIcucucucuculIlIBMHEHEjkjkjkjkjkjkjkjkjkjkHETSTSpsTSTSTSpspsTSTSTSjkjkjkjkjkxXxXxXxXxXxX
xXxXxXxXxXxXNqqTqTqTqTqTqTTSHEHEHEHEHEHEHEHEynTSlIlITSlIlIlIlIlIlIlIlIlITSlIlIlITSlrlrlrlrqTjkjkjkjkHEHEHEjkBMlIlIcucucucuculIlIBMHEHEjkjkHEHEHEHEHEHEHEHEHETSpspspspspspspsTSxXxXjkjkjkjkjkxXxXxXxXxXxX
xXxXxXxXxXxXNqqTHEHEHEHEHETSHEHEHEHEHEHEHEHEHETSlIlIlIlIwFwFwFlIwFwFwFlITSlIlIlIlIlrlrlrlrqTjkjkjkjkHEHEHEjkBMlIlIcucucucuculIlIBMHEHEjkjkHETSTSTSTSTSTSTSTSTSpspspspspspspsTSxXxXjkjkjkjkjkxXxXxXxXxXxX
xXxXxXxXxXxXNqqTHEHEHEHEHETSTSTSTSHEHEynTSPgTSTSlITSTSTSxkxkxkTSxkxkxkTSTSlIlIlITSlrlrlrlrqTjkjkjkjkHEHEHEjkBMlIlIcucucucuculIlIBMHEHEHEHEHETSpsTSpsTSpspspspspspspspspspspsTSxXxXxXxXNqNqNqxXxXxXxXxXxX
xXxXxXxXxXxXNqqTHEHEHEHEHEHEHEHEHEHEHEHETSPgPgTSHEHEjkjkjkjkjkjkjkjkjkjkTSTSlITSTSqTlrqTqTqTjkjkjkjkHEHEHEjkBMBMlrBMBMlIBMBMlrBMBMHEHEHEHEHEpspspspspspspspspspspspspspspspspsHEHExXxXNqNqNqxXxXxXxXxXxX
xXxXxXxXxXxXNqqTHEHEHEHEHETSTSTSTSHEHEHEPgPgPgTSHEHEHEHEHEHEHEHEHEHEjkjkjkHEHEHEjkjkHEjkjkjkjkjkjkjkHEHEHEjkjkjkjkjkjkHEjkjkjkjkjkHEHEHEHEHETSpspspsTSpspspspspspspspspspspsTSHEHExXxXNqNqNqxXxXxXxXxXxX
xXxXxXxXxXxXNqqTHEHEHEHEHETSynynynHEHEHETSPgPgPgHEHEHEHEHEHEHEHEHEHEjkjkjkHEHEHEjkjkHEjkjkjkjkjkjkjkHEHEHEjkjkjkjkjkHEHEHEjkjkjkjkHEHEHEHEHETSTSTSTSTSpspsqTqTqTqTqTqTqTqTqTqTHEHExXxXNqNqNqxXxXxXxXxXxX
xXxXxXxXxXxXqTqTIdqTqTqTqTTSynynynHEHEHETSTSTSTSHEHEHEHEHEHEHEHEHEHEjkjkjkHEHEHEjkjkHEjkjkjkjkjkjkjkHEHEHEjkjkjkjkHEHEHEHEHEHEHEHEHEHEjkjkjkjkjkjkjkTSpsTSqTlrlrlrlrlrlrlrlrqTHEHExXxXNqNqNqxXxXxXxXxXxX
xXxXxXxXxXxXqTIdIdqTynynynqTHEHEHEHEHEHEHEHEqTqTqTqTqTjkjkjkjkHEHEHEjkjkjkHEHEHEjkjkHEjkjkjkjkjkjkjkHEHEHEjkjkjkjkHEHEHEHEHEHEHEHEHEHEjkjkjkTSTSTSTSTSpspsqTlrqTqTqTqTqTqTlrqTHEHExXxXNqNqNqxXxXxXxXxXxX
xXxXxXxXxXxXqTIdIdqTynynynHEHEHEHEHEHEHEHEHEHElrlrlrlrHEHEHEHEHEHEHEHEHEHEHEHEHEHEHEHEHEHEHEHEHEHEHEHEHEHEHEHEHEHEHEHEHEHEHEHEHEHEHEHEjkjkjkTSpspspsTSpspsqTlrqTpspspspsqTlrqTHEHExXxXNqNqNqxXxXxXxXxXxX
xXxXxXxXxXxXqTIdIdqTynynynqTTSHETSTSTSTSHETSqTlrlrlrqTlzlzjkjkjkHEHEHEHEHEHEHEHEHEHEHEHEHEHEHEHEHEHEHEHEHEHEHEHEHEHEHEHEHEHEHEHEHEHEHEjkjkjklrpspspsTSpspsqTqTqTpspspspsqTlrqTHEHExXxXNqNqNqxXxXxXxXxXxX
xXxXxXxXxXxXqTIdIdqTynynynqTHEHEHEHEHEHEHEHEqTqTqTqTqTlzlzlzlzjkHEHEHEHEHEHEHEHEHEHEHEHEHEHEHEHEHEHEHEHEHEHEHEHEHEHEHEHEHEHEHEHEHEHEHEjkjkjkTSpspspspspspsqTpspspspspspsqTlrqTHEHEjkxXNqNqNqxXxXxXxXxXxX
xXxXxXxXxXxXqTlrlrqTqTqTqTqTHEHEHEHEHEHEHEHETSlzlzlzlzlzlzlzlzjkHEHEHEjkjkjkjkHEHEjkjkjkjkjkjkjkjkjkHEHEHEjkjkjkjkjkjkjkjkjkjkHEHEHEHEHEHEHEpspspspsTSpspspspspspspspspsqTlrqTHEHEjkxXNqNqNqxXxXxXxXxXxX
xXxXxXxXxXxXlzlZlZlZlzlzlzqTHEHEHEHEHEHEHEHETSlzlzlzlzlzlzlzHEHEHEHEjkjkjkjkjkHEHEjkjkjkjkjkjkjkjkjkHEHEHEjkjkjkjkjkjkjkjkjkjkHEHEHEHEjkjkjkTSpspspsTSpsTSqTpspspspspspsqTlrqTHEHEjkxXxXNqNqxXxXxXxXxXxX
xXxXxXxXxXxXlzlZlZlZlzlzlzqTqTqTqTqTqTqTqTqTqTlzlzlzlzlzlzHEHEHEHEjkjkjkjkjkjkHEHEqTqTqTlIqTqTqTjkjkHEHEHEjkjkqTqTlIlIlIqTqTjkHEHEHEjkjkjkjklrpspspspspspsqTqTqTpspspspsqTlrqTHEHENqxXxXxXNqxXxXxXxXxXxX
xXxXxXxXxXxXlzlZlZlZlzlzlzNqTSBRBRBRBRTSBRBRTSlzlzlzlzlzHEHEHEHEjkjkjkjkjkjkjkHEHEqTBRBRlIlIlIqTjkjkHEHEHEjkjkqTlIlIlIlIlIqTjkHEHEHEjkjkjkjkTSpspspspspspsqTlrqTpspspspsqTlrqTHEHENqNqxXxXxXxXxXxXxXxXxX
xXxXxXxXxXxXlzlzlZlZlzlzlzNqTSTSTSBRBRBRBRBRTSTSTSTSlzHEHEHEHEjkjkTSTSTSTSTSjkHEHEqTqTqTBRqTqTqTjkjkHEHEHEjkjklIlIxsxsxslIlIjkHEHEHEjkjkjkjkTSTSTSlrlrTSTSqTlrqTqTqTqTqTqTlrqTHEHENqNqNqNqNqxXxXxXxXxXxX
xXxXxXxXxXxXlzlzlzlZlzlzlzNqTSBRBRBRTSTSTSTSTSPgPgTSlZHEHEHEjkjkTSTSlIlIlITSjkHEHEqThZhZhZlIlIqTjkjkHEHEHEjkjklIlIxsxsxslIlIjkHEHEHEjkjkjkjkjkjkjkjkjkjkjkqTlrlrlrlrlrlrlrlrqTHEHENqNqNqNqNqxXxXxXxXxXxX
xXxXxXxXxXxXlzlzlzNqlzlzlzNqTSTSTSBRTSynynynPglrPglrlZHEHEHEjkTSTSlIlIlIlITSTSHEHEqThZhZhZlIlIqTjkjkHEHEjkjkjkqTlIxsxsxslIqTjkHEHEHEjkjkjkjkjkjkjkjkjkjkjkqTqTqTqTqTqTqTqTqTqTHEHENqNqNqNqNqxXxXxXxXxXxX
xXxXxXxXxXxXlzNqlzNqlzlzlzNqTSPgPgPgPgPgPgPglrPgPglrlZHEHEHElZlrlIlIlIhZhZhZTSHEHEqThZhZhZlIlIqTqTqTqTlIqTqTqTqTlIxsxsxslIqTjkHEHEHEHEHEHEHEHEHEHEHEHEHEHEHEHEHEHEHEHEHEHEHEHEHEHENqNqNqNqNqxXxXxXxXxXxX
xXxXxXxXxXxXlzNqlzNqlzlzlzNqTSPgPgPgPgPgPgPgPgPgPgTSlZHEHEHElZlrlIlIlIhZhZhZTSHEHEqTlIlIlIlIlIqTlIlIlIAUlIlIlIqTlIxsxsxslIlIjkHEHEHEHEHEHEHEHEHEHEHEHEHEHEHEHEHEHEHEHEHEHEHEHEHEHENqNqNqNqNqxXxXxXxXxXxX
xXxXxXxXxXxXNqNqNqNqlzlzlzNqTSTSPgTSlrlrTSTSPgPgPgTSTSHEHEHEHETSlIlIlIhZhZhZTSHEHEqTlIlIlIlIlIqTlIlIlIAUlIlIlIqTlIxsxsxslIlIjkHEHEHEjkjkjkjkjkjkjkjkjkjkjkjkjkjkjkjkjkjkjkjkjkjkNqNqNqNqNqNqxXxXxXxXxXxX
xXxXxXxXxXxXNqNqNqNqlzlzlzNqTSPgPgPgPglrPgTSPgPgPgPgPgHEHEHEHElIlIlIlIhZhZhZTSHEHEqTlIlIlIlIlIqTlIlIlIAUlIlIlIAUlIxsxsxslIlIjkHEHEHEjkjkjkjkjkjkjkjkjkjkjkjkTSTSTSTSTSqTqTqTqTqTqTNqNqNqNqNqxXxXxXxXxXxX
xXxXxXxXxXxXNqNqNqNqlzlzlzNqTSPgPgPglrPgPgTSlrlrlrTSTSHEHEHEHETSlIlIlIhZhZhZTSHEHEqTqTqTlIqTqTqTlIlIlIAUAUAUAUAUlIlIlIlIlIqTjkHEHEHEjkjkjkjkjkjkjkjkjkjkjkjkTSOoOoOoOoqTlrlrlrlrqTNqNqNqNqNqxXxXxXxXxXxX
xXxXxXxXxXxXNqNqNqNqlzlzlzNqTSPglrPgPgPgsDTSPgPgPgTSlZHEHEHElZlrlIlIlIhZhZhZTSHEHEHElrlrlIlIlIlIlIlIlIAUlIlIlIAUlIlIlIlIlIqTjkHEHEHEjkjkjkjkjkjkjkjkqTqTqTqTTSOoOoOoOoqTlrlrlrlrqTNqNqNqNqNqxXxXxXxXxXxX
xXxXxXxXxXxXNqNqNqNqlzlzlzNqTSPgPgPglrPgsDTSPgPgPgTSlZHEHEHElZlrlIlIlIlIlIlITSHEHEqTlrlrlIlIlIlIlIlIlIAUlIlIlIqTlIlIlIlIlIqTjkHEHEHEHEHEHEHEHEHEHEHEHElrlrlrTSTSTSOoTSqTlrlrKfKfqTNqNqNqNqNqxXxXxXxXxXxX
xXxXxXxXxXxXlzlzlzlzlzlzlzlzTSTSTSTSTSTSTSTSTSTSTSTSlZHEHEHElZTSTSlIlIlIlITSTSHEHEHElrlrlIqTlIqTqTlIlIlIlIlIqTqTDSDSqTqTqTqTjkHEHEHEjkjkjkjkjkjkjkjkqTlrlrlrqTOoOoOoOoqTlrlrKfKfqTNqNqNqNqNqxXxXxXxXxXxX
xXxXxXxXxXxXlzlzlzlzlzlzlzlzlzlzlzlzlzlzlzlzlzlzlzlzlZHEHEHElZlZTSTSlIlIlITSqTHEHEqTqTqTqTqTlIlIlIlIlIlIlIxsxsqTDSDSqTjkjkjkjkHEHEHEjkjkjkqTqTqTqTqTqTlrlrlrqTOoOoOoOoqTKfKfKfKfqTNqNqNqNqNqxXxXxXxXxXxX
xXxXxXxXxXxXlzlzlzlzlzlzlzlzlzlzlzlzlzlzlzlzlzlzlzlzlzTSlrlrTSlZlZTSTSTSTSTSqTHEHEjkjkjkqTqTqTqTlIlIlIlIlIxsxsqTqTqTqTjkjkjkjkHEHEHEjkjkqTqTlrlrlrqTqTlrlrlrTSOoOoOoOoqTqTKfKfqTqTTSTSTSTSTSxXxXxXxXxXxX
xXxXxXxXxXxXlzlzlzlzlzlzlzlzlzlzlzlzlzlzlzlzlzlzlzlzlzlrlrlrlrlzlzlzNqqTsqsqqTHEHEjkjkjkjkjkjkqTqTqTqTlIqTqTqTqTjkjkjkjkjkjkjkHEHEHEjkjkqTynynynynynqTqTlrqTTSOoOoOoOoTSQwQwQwQwTSHEkOkOkOTSxXxXxXxXxXxX
xXxXxXxXxXxXlzlzlzlzlzlzlzlzlzlzlzlzlzlzlzlzlzlzlzlzlzTSlrlrTSlzlzlzNqqTsqsqlrHEHEHEHEHEHEHEHEHEHEHEHEHEHEHEHEHEHEHEHEHEjkjkjkHEHEHEjkjkqTynynynynynqTOoOoOoTSOoOoOoOoTSQwQwQwQwTSHEkOkOkOTSxXxXxXxXxXxX
xXxXxXxXxXxXlzlzlzlzlzlzlzlzlzlzlzlzlzlzlzlzlzlzlzlzlzTSlrlrTSlzlzlzNqqTqTqTqTHEHEHEHEHEHEHEHEHEHEHEHEHEHEHEHEHEHEHEHEHEHEjkjkHEHEHEjkjkqTynynynynynqTOoOoOoTSOoOoOoOoOoQwQwQwQwTSHEkOkOkOTSxXxXxXxXxXxX
xXxXxXxXxXxXlzlzlzlzlzlzlzlzlzlzlzqTqTqTqTqTlzlzlzlzlZlZlZlZlZlZlZlzlzNqlzlzCuCuCuCuCudSdSKZKZKZHEHEHEHEHEHEHEHEHEHEHEHEHEHEjkHEHEHEjkjkqTynynynynynqTOoOoOoOoOoOoOoOoTSQwQwQwQwTSHEHEHEHETSxXxXxXxXxXxX
xXxXxXxXxXxXlzlzlzlzlzlzlzlzlzlzlzqTDSDSDSqTlzlzlZlZlZlZlZlZlZlZlZlzlzlzlzCuCuCuCuCuCudSdSKZKZKZHEHEBMuNHEHEHEHEHEuNBMHEHEHEHEHEHEHEjkjkqTynynynynynqTOoOoOoTSOoOoOoOoTSQwQwQwQwTSHEHEHEHETSxXxXxXxXxXxX
xXxXxXxXxXxXlzlzlzlzlzlzlzlzlzlzlzqTDSDSDSqTlZlZlZlZlZlZlZlZlZlzlzlzlzlzCuCuCuCuCuCuCudSdSKZKZKZHEHEHEuNuNuNuNuNuNuNHEHEHEHEHEHEHEHEjkjkqTynynynynynqTTSTSTSTSTSOoOoTSTSTSTSTSTSTSKfTSKfTSTSxXxXxXxXxXxX
xXxXxXxXxXxXlzlzlzlzlzlzlzlzlzlzlzqTsDsDDSDSlZlZlZlzlzlzlZlZNqlzlzlzlzlzlzmymymymymymydSdSKZKZKZHEHEHEuNuNuNuNuNuNuNHEHEHEHEHEHEHEHEjkjkqTynynynynynqTPgPgPgPgPgPgPgPgPgPgPgPgPgPgPgPgPgPgTSxXxXxXxXxXxX
xXxXxXxXxXxXlzlzlzlzlzlzlzlzlzlzlzqTsDsDDSqTlZlZNqlzlzlzlzlzlzlzlzlzlzlzlzCuCuCuCuCuCudSdSKZKZKZHEHEBMuNuNuNuNuNuNuNBMHEHEHEHEHEHEHEjkjkqTqTynynynqTqTPgPgPgPgPgPgPgPgPgPgPgPgPgPgPgPgPgPgTSxXxXxXxXxXxX
xXxXxXxXxXxXlzlzlzlzlzlzlzlzlzlzlzqTqTqTqTqTlZlzlzlzlzlzlzlzlzlzlzlzlzlzlzlzCuCuCuCuCudSdSKZKZKZHEHEHEHEHEHEHEHEHEHEHEHEHEHEHEHEHEHEjkjkTSqTqTynqTqTTSPgPgPgPgPgPgPgPgPgPgPgPgPgPgPgPgPgPgTSxXxXxXxXxXxX
xXxXxXxXxXxXlzlzlzlzlzlzlzlzlzlzlzlzlzlzlzlzlzlzlzlzlzlzlzlzlzlzlzlzlzlzlzlzlzCudSdSdSdSdSKZKZKZHEHEHEHEHEHEHEHEHEHEHEHEHEHEHEHEHEHEHEHETSPgPgPgPgPgTSPgPgPgPgPgPgPgPgTSPgPgPgPgPgPgPgPgPgTSxXxXxXxXxXxX
xXxXxXxXxXxXlzlzlzlzlzlzlzlzlzlzlzlzlzlzlzlzlzlzlzlzlzlzlzlzlzlzlzlzlzlzlzlzlzCudSdSdSdSdSKZKZKZHEjkHEHEHEHEHEHEHEHEHEjkHEHEHEHEHEHEHEHEPgPgPgPgPgPgPgPgPgPgPgPgPgPgPgTSPgPgPgPgPgPgPgPgPgTSxXxXxXxXxXxX
xXxXxXxXxXxXlzlzlzlzlzlzlzlzlzlzlzlzlzlzlzlzlzlzlzlzlzlzlzlzlzlzlzlzlzlzlzlzlzCudSdSdSdSdSKZKZKZHEjkHEHEHEHEHEHEHEHEHEjkHEHEHEHEHEHEHEHETSPgPgPgPgPgTSPgPgPgPgPgPgPgPgTSPgPgPgPgPgPgPgPgPgTSxXxXxXxXxXxX
xXxXxXxXxXxXlzlzlzlzlzlzlzlzlzlzlzlzlzlzlzlzlzlzlzlzlzlzlzlzlzlzlzlzlzlzlzlzdSdSdSdSdSdSdSBMjkjkHEjkHEHEHEHEHEHEHEHEHEjkHEHEHEHEHEHEjkjkTSPgPgPgPgPgTSTSTSTSTSTSPgPgPgTSPgPgPgPgPgPgPgPgPgTSxXxXxXxXxXxX
xXxXxXxXxXxXlzlzlzlzlzlzlzlzlzlzlzlzlzlzlzlzlzlzlzlzlzlzlzlzlzlzlzlzjklzlzlzdSdSdSdSdSdSdSBMjkjkHEjkHEHEHEHEHEHEHEHEHEjkHEHEHEHEHEHEjkjkTSPgPgPgPgPgTSynynynynTSPgPgPgTSPgPgqTqTqTPgqTPgPgTSxXxXxXxXxXxX
xXxXxXxXxXxXlzlzlzlzlzlzlzlzlzlzlzlzlzlzlzlzlzlzlzlzlzlzlzlzlzlzlzjkjkBMBMBMBMBMlrBMBMdSdSBMBMBMBMBMHEHEHEHEHEHEHEHEHEHEHEHEHEHEHEHEjkjkTSPgPgPgPgPgPgPgPgPgPgPgPgPgPgTSPgPgqTlrlrlrqTPgPgTSxXxXxXxXxXxX
xXxXxXxXxXxXlzlzlzlzlzlzlzlzlzlzlzlzlzlzlzlzlzlzlzlzlzlzlzlzlzlzlzjkjkBMororBMlIlIBMlIlIlIlIlIlIlIlrHEHEHEHEHEHEHEHEHEHEHEHEHEHEHEHEHEjkTSTSTSTSTSTSTSTSTSTSTSqTqTqTqTqTqTqTqTlrlrlrqTqTqTqTxXxXxXxXxXxX
xXxXxXxXxXxXlzlzlzlzlzlzlzlzlzlzlzlzlzlzlzlzlzlzlzlzlzlzlzlzlzlzlzjkjkBMororlIlIlIBMlIlIlIlIlIlIlIlrHEHEHEHEHEHEHEHEHEHEHEHEHEHEHEHEHEHEHEHEHEHEHEHEHEHEHEHEHEDSDSbmbmbmbmbmqTqTqTlrqTDSDSqTqTqTqTqTxXxX
xXxXxXxXxXxXlzlzlzlzlzlzlzlzlzlzlzlzlzlzlzlzlzlzlzlzlzlzlzlzlzlzlzlzjkBMBMBMBMlIlIlIlIlIlIlIlIlIlIlrHEHEHEHEHEHEHEHEHEHEHEHEHEHEHEHEHEHEHEHEHEHEHEHEHEHEHEHEHEDSDSbmbmbmbmbmbmbmbmbmbmDSDSPgqThjhjqTxXxX
xXxXxXxXxXxXlzlzlzlzlzlzlzlzlzlzlzlzlzlzlzlzlzlzlzlzlzlzlzlzlzlzlzlzlzBMBRBRBRlIlIBMlIlIlIlIlIlIlIlrHEHEHEBMBMBMHEHEHEHEHEjkjkjkjkHEHEHEjkjkjkjkHEHEjklrlrlrqTqTDSDSDSDSDSDSDSDSDSbmbmDSDSlrhjhjhjqTxXxX
xXxXxXxXxXxXlzlzlzlzlzlzlzlzlzlzlzlzlzlzlzlzlzlzTSTSTSTSTSTSTSTSTSTSTSBMBRBRBMlIlIBMlIlIlIlIlIlIlIlrHEHEHEHEHEHEHEHEHEHEjkjkjkTSlrTSDSTSlrTSjkjkHEHElrlrDSDSDSTSPgTSTSlrlrlrTSTSDSbmbmDSDShjhjhjhjqTxXxX
xXxXxXxXxXxXlzlzlzlzlzlzlzlzlzlzlzlzlzlzlzlzlzlzTSlIhNsqsqsqsqsqhNlITSBMBMBMBMBMBMBMBMlrBMlIBMlrBMBMHEHEHEHEHEHEHETSTSTSTSTSTSTSDSDSDSDSDSTSTSTSHEHElrDSDSDSDSDSDSTSPgPgPgPgPgTSDSbmbmDSDSlrhjhjhjqTxXxX
xXxXxXxXxXxXlzlzlzlzlzlzlzlzlzlzlzlzlzlzlzlzlzlzTSlIsqbObObObObOsqlITSNqjkjkjkjkHEjkjkjkjkHEjkjkjkjkHEHEHEHEHEHEHElrlrlrlrlrDSDSDSDSDSDSDSDSDSlrHEHEHEDSDSDSDSDSDSlrPgPgPgPgPgTSDSbmbmDSDSPgqThjhjqTxXxX
xXxXxXxXxXxXlzlzlzlzlzlzlzlzlzlzlzlzlzlzlzlzlzlzTSlIsqbOynynynbOsqlITSHEHEHEHEHEHEHEHEHEHEHEHEHEHEHEHEHEHEHEHEHEHETSlrlrlrTSDSDSDSDSDSDSDSDSDSlrHEHElrDSDSDSDSDSDSlrPgPgPgPgPgTSDSbmbmDSDSqTqTqTqTqTxXxX
xXxXxXxXxXxXlzlzlzlzlzlzlzlzlzlzlzlzlzlzlzlzlzlzTSlIsqbOynynynbOsqlIlIHEHEHEHEHEHEHEHEHEHEHEHEHEHEHEHEHEHEHEHEHEjkTSTSTSTSTSDSDSDSDSDSDSDSDSDSTSHEHEqTlrlrqTTSTSTSTSPgPgPgPgTSTSlrbmbmlrTSTSxXxXxXxXxXxX
xXxXxXxXxXxXxXlzlzlzlzlzlzlzlzlzlzlzlzlzlzlzlzlzTSlIsqbOynynynbOsqlITSHEHEHEHEHEHEHEHEHEHEHEHEHEHEHEHEHEHEHEHEjkTSTSBRBRBRTSDSDSDSDSDSDSDSDSDSTSHEHEHEHEHEHEynDSDSDSDSPgPgPgTSDSDSbmbmDSDSTSxXxXxXxXxXxX
xXxXxXxXxXxXxXxXlzlzlzlzlzlzlzlzlzlzlzlzlzlzlzlzTSlIsqbObObObObOsqlITSjkjkHEjkTSTSTSTSTSjkHEHEHEjkjkjkjkjkjkjkTSTSBRBRBRBRTSDSDSDSDSDSDSDSDSDSTSHEHEHEHEHEHEynynynynDSPgPgPgTSDSDSbmbmDSDSTSxXxXxXxXxXxX
xXxXxXxXxXxXxXxXxXlzlzlzlzlzlzlzlzlzlzlzlzlzlzlzTSlIhNsqsqsqsqsqhNlITSBMBMIdBMTSlrlrlrTSjkHEHEHEjkjkjkjkjkTSTSTSBRBRBRBRBRTSDSlrTSTSDSTSlrlrTSTSTSTSTSTSOoTSTSTSBRynDSPgPgPgTSDSbmbmbmbmDSTSxXxXxXxXxXxX
xXxXxXxXxXxXxXxXxXlZlZlZlZlZlZlzlzlzlzlzlzlzlzlzTSTSTSTSTSTSTSTSTSTSTSBMIdIdIdTSlrlrlrHEHEHEHEHEHEHEHEHEHEDSDSDSDSDSDSDSDSDSDSDSDSDSDSDSBRBRDSDSDSOoOoOoOoOoOoTSBRynDSDSDSDSDSDSbmbmbmbmDSTSxXxXxXxXxXxX
xXxXxXxXxXxXxXxXlZlZlZlZlZlZlZlZlzlzlzlzlzlzlzlzlzlzlzlzlzlzlzlzlzlzlzBMIdIdIdlrlrlrlrTSHEHEHEHEHEHEHEHEHEDSDSDSDSDSDSDSDSDSDSDSDSDSDSDSDSDSDSDSDSDSOoOoOoOoOoTSBRynynynynynTSDSbmbmbmbmDSTSxXxXxXxXxXxX
xXxXxXxXxXxXxXlZlZlZlZlZlZlZlZlZlzlzlzlzlzlzlzlzBMBMBMBMBMBMBMBMBMBMBMBMIdIdIdTSTSTSTSTSjkHEHEHEjkjkjkjkTSTSlrlrlrTSTSTSDSTSTSDSDSDSDSDSDSDSDSDSBROoOoOoOoOoOoTSTSTSTSTSTSTSTSDSbmbmbmbmDSTSxXxXxXxXxXxX
xXxXxXxXxXxXxXlZlZlZlZlZlZlZlZlZlZlzlzlzlzlzlzlzBMIdIdIdIdIdBMIdIdIdIdIdIdIdIdorororBMjkjkHEHEHEjkjkjkjkTSDSDSDSDSTSDSDSDSDSTSDSDSDSDSDSDSTSTSDSTSTSOoOoOoOoOoTSDSDSDSDSDSDSTSDSbmbmbmbmDSTSxXxXxXxXxXxX
xXxXxXxXxXxXxXlZlZlZlZlZlZlZlZlZlZlZlzlzlzlzlzlzBMhZhZhZIdIdIdIdIdIdIdIdIdIdIdorororBMjkTSTSPgTSTSTSTSjkTSDSBRBRBRTSDSDSDSDSTSDSDSDSDSDSDSTSDSDSDSDSDSDSDSDSDSTSDSDSDSDSDSDSDSDSbmbmbmbmDSTSxXxXxXxXxXxX
xXxXxXxXxXxXxXlZlZlZlZlZlZlZlZlZlZlZlzlzlzlzlzlzBMhZhZhZIdIdBMIdIdIdIdIdIdIdIdorororBMjkTSPgPgPgPgPgTSjkTSDSBRBRBRTSDSDSDSDSTSTSTSDSDSTSTSTSDSDSBRBRBRBRBRBRBRTSDSDSDSDSDSDSqTlrlrlrPgqTlrqTxXxXxXxXxXxX
xXxXxXxXxXxXxXlZlZlZlZlZlZlZlZlZlZlZlzlzlzlzlzlzBMhZhZhZIdIdBMIdIdIdIdIdIdIdIdorororBMjkTSPgPgPgPgPgTSjkTSDSBRBRBRTSDSDSDSDSTSDSDSLxLxDSDSTSDSDSBRBRBRBRBRBRBRlrDSDSDSDSDSDSlrDSDSDSDSDSDSqTxXxXxXxXxXxX
xXxXxXxXxXxXxXlZlZlZlZlZlZlZlZlZlZlZlzlzlzlzlzlzBMIdIdIdIdIdBMIdIdIdIdIdIdIdIdIdIdIdBMjkTSPgPgPgPgPgTSjkTSDSDSDSDSTSDSDSDSDSTSDSDSLxLxDSDSlrDSDSBRBRBRBRBRBRBRlrDSDSbmbmDSDSlrDSDSDSDSDSDSqTxXxXxXxXxXxX
xXxXxXxXxXxXxXlZlZlZlZlZlZlZlZlZlZlZlzlzlzlzlzlzBMBMBMBMBMBMBMIdIdIdIdIdIdIdIdIdIdIdBMjkTSTSPgTSTSTSTSjkTSTSTSTSTSTSTSTSDSTSTSDSDSLxLxDSDSlrDSDSTSTSTSTSTSTSTSTSDSDSbmbmDSDSqTDSDSDSDSDSDSqTxXxXxXxXxXxX
xXxXxXxXxXxXxXlZlZlZlZlZlZlZlZlZlZlZlzlzlzlzlzlzBMIdIdIdIdIdIdIdIdIdIdIdIdIdIdIdIdIdIdjkTSPgPgTSTSTSTSTSTSDSDSDSDSDSDSDSDSDSTSDSDSLxLxDSDSTSTSTSTSNqNqNqNqNqNqTSDSDSDSDSDSDSqTDSDSDSDSDSDSqTxXxXxXxXxXxX
xXxXxXxXxXxXxXlZlZlZlZlZlZlZlZlZlZlZlzlzlzlzlzlzBMIdIdIdIdIdIdIdIdIdIdIdIdIdIdIdIdIdBMjkTSPgPgTSBRBRBRBRTSDSDSDSDSDSDSDSDSDSlrDSDSLxLxLxLxTSNqNqNqNqNqNqNqNqNqTSDSDSDSDSDSDSqTqTqTqTynqTqTqTxXxXxXxXxXxX
xXxXxXxXxXxXxXlZlZlZlZlZlZlZlZlZlZlzlzlzlzlzlzlzBMIdIdIdIdIdIdIdIdIdIdIdIdIdIdIdIdIdBMjkTSPgPgTSTSTSBRBRBRDSDSDSDSDSDSDSDSDSlrDSDSLxLxLxLxTSNqNqNqNqNqNqNqNqNqTSDSDSDSDSDSDSqTsqynynynynynqTxXxXxXxXxXxX
xXxXxXxXxXxXxXxXlZlZlZlZlZlZlZlZlzlzlzlzlzlzlzlzBMIdIdIdIdIdBMIdIdIdIdIdIdIdIdIdIdIdBMVCjkPgPgTSBRBRBRBRTSDSDSDSDSDSDSDSDSDSTSTSTSTSTSTSTSTSNqNqNqNqNqNqNqNqNqTSDSDSDSDSDSDSqTsqynynynynynqTxXxXxXxXxXxX
xXxXxXxXxXxXxXxXxXlZlZlZlZlZlZlzlzlzlzlzlzlzlzlzBMBMBMBMBMBMBMBMBMBMBMBMBMBMBMBMBMBMBMBMBMTSTSTSTSTSTSTSTSTSTSTSTSTSTSTSTSTSTSNqNqNqNqNqNqNqNqNqNqNqNqNqNqNqNqTSBRBRBRBRBRBRqTqTqTqTqTqTqTqTxXxXxXxXxXxX
xXxXxXxXxXxXxXxXxXxXxXxXxXxXxXxXxXxXxXxXxXxXxXxXxXxXxXxXxXxXxXxXxXxXxXxXxXxXxXxXxXxXxXxXxXxXxXxXxXxXxXxXxXxXxXxXxXxXxXxXxXxXxXxXxXxXxXxXxXxXxXxXxXxXxXxXxXxXxXTSTSTSTSTSTSTSTSxXxXxXxXxXxXxXxXxXxXxXxXxX
xXxXxXxXxXxXxXxXxXxXxXxXxXxXxXxXxXxXxXxXxXxXxXxXxXxXxXxXxXxXxXxXxXxXxXxXxXxXxXxXxXxXxXxXxXxXxXxXxXxXxXxXxXxXxXxXxXxXxXxXxXxXxXxXxXxXxXxXxXxXxXxXxXxXxXxXxXxXxXxXxXxXxXxXxXxXxXxXxXxXxXxXxXxXxXxXxXxXxXxX
xXxXxXxXxXxXxXxXxXxXxXxXxXxXxXxXxXxXxXxXxXxXxXxXxXxXxXxXxXxXxXxXxXxXxXxXxXxXxXxXxXxXxXxXxXxXxXxXxXxXxXxXxXxXxXxXxXxXxXxXxXxXxXxXxXxXxXxXxXxXxXxXxXxXxXxXxXxXxXxXxXxXxXxXxXxXxXxXxXxXxXxXxXxXxXxXxXxXxXxX
xXxXxXxXxXxXxXxXxXxXxXxXxXxXxXxXxXxXxXxXxXxXxXxXxXxXxXxXxXxXxXxXxXxXxXxXxXxXxXxXxXxXxXxXxXxXxXxXxXxXxXxXxXxXxXxXxXxXxXxXxXxXxXxXxXxXxXxXxXxXxXxXxXxXxXxXxXxXxXxXxXxXxXxXxXxXxXxXxXxXxXxXxXxXxXxXxXxXxXxX
xXxXxXxXxXxXxXxXxXxXxXxXxXxXxXxXxXxXxXxXxXxXxXxXxXxXxXxXxXxXxXxXxXxXxXxXxXxXxXxXxXxXxXxXxXxXxXxXxXxXxXxXxXxXxXxXxXxXxXxXxXxXxXxXxXxXxXxXxXxXxXxXxXxXxXxXxXxXxXxXxXxXxXxXxXxXxXxXxXxXxXxXxXxXxXxXxXxXxXxX
xXxXxXxXxXxXxXxXxXxXxXxXxXxXxXxXxXxXxXxXxXxXxXxXxXxXxXxXxXxXxXxXxXxXxXxXxXxXxXxXxXxXxXxXxXxXxXxXxXxXxXxXxXxXxXxXxXxXxXxXxXxXxXxXxXxXxXxXxXxXxXxXxXxXxXxXxXxXxXxXxXxXxXxXxXxXxXxXxXxXxXxXxXxXxXxXxXxXxXxX
"}
